NO /home/mgimon/Cub3d/textures/simonkraft/wet_sponge.xpm
SO /home/mgimon/Cub3d/textures/simonkraft/wet_sponge.xpm
WE /home/mgimon/Cub3d/textures/simonkraft/wet_sponge.xpm
EA /home/mgimon/Cub3d/textures/simonkraft/wet_sponge.xpm

C 53,41,34
F 45,33,27

1111111
1000001
1011111
1000001
10N0001
1111111