NO textures/simonkraft/soul_sand.xpm
SO textures/simonkraft/soul_soil_01.xpm
WE textures/simonkraft/soul_soil.xpm
EA textures/simonkraft/soul_sand.xpm

C 53,41,34
F 45,33,27

1111 11111111111 111
10011100000000011101
10000000000000000001
1111000N000111111110
   10000000111111111
11111111111111111111