NO textures/simonkraft/soul_sand.xpm
SO textures/simonkraft/soul_soil_01.xpm
WE textures/simonkraft/soul_soil.xpm
EA textures/simonkraft/soul_sand.xpm

C 53,41,34
F 45,33,27

11111111111111111111
11111101111111111111
11111111111111111111
11111111111111111111
11111111111111111111
11111111111111111111
